6, 9
5, 8
0 0 G X 0 0 0 0 0
0 X 0 0 0 X X X 0
0 0 0 0 0 X X X 0
0 0 0 X 0 X 0 0 0
0 X 0 X 0 X 0 X X
P X D 0 0 X 0 0 0
