10, 10
5, 8
X X 0 X 0 0 0 0 0 G
0 X 0 0 0 X X X 0 X
0 0 X 0 0 X X X X 0
0 0 0 X 0 X 0 0 0 X
0 X 0 X 0 X 0 X X 0
0 X P X 0 X 0 0 0 0
0 X X 0 0 X 0 X X 0
0 0 0 0 0 X 0 X 0 D
0 0 X X 0 0 0 0 0 0
X 0 X X 0 X X X D G
